################
#               #
#  *#.$ #  ###  #
#  # # $.   #   #
#  ###  #   #   #
#  # #  #   #   #
#  #@#  #  ###  #
#               #
#################