#######
# ..  #
# # $ #
#     #
###$ ##
  # @#
  ####