  ####
  #@ ### 
###*   ##
#  $ #  #
# #**$*.#
#     $ #
##..#**##
 #     #
 #   ###
 #####