 #######
 #  +  #
##$#*#$##
#   .   #
# $ . $ #
## #*# ##
 #  .  #
 #######